czyœæ	CLEAN
posprz¹taj	CLEAN
sprz¹tnij	CLEAN
wyczyœæ	CLEAN
zbierz	CLEAN
posprzataj	CLEAN
sprzataj	CLEAN
wyczysc	CLEAN
wszystko	ALL
wszystkie	ALL
wszystkich	ALL
ka¿d¹	ALL
ka¿da	ALL
kazda	ALL
ulica	STREET
ulicach	STREET
ulice	STREET
okolice	STREET
szybka	STREETNAME
wredna	STREETNAME
nowoczesna	STREETNAME
umultowska	STREETNAME
bez	WITHOUT
nie	NOT
